//path taken
(0,0,0,e)
(0,0,1,s)
(0,1,1,s)
(1,2,1,w)
(1,2,1,w)
(1,2,0,n)
(1,1,0,n)
(1,1,0,n)
(1,0,0,e)
