L
2
3
(0,0,0,E)
(0,0,1,E)
(0,0,2,E)
(0,1,0,E)
(0,2,0,E)
(0,1,1,S)
(0,2,1,E)
(0,2,2,E)
(0,1,2,E)

(1,0,0,E)
(1,0,1,E)
(1,0,2,E)
(1,1,0,E)
(1,2,0,H)
(1,1,1,E)
(1,2,1,E)
(1,2,2,E)
(1,1,2,E)