L
3
4
(1,1,0,#)
(1,3,0,#)
(0,0,1,#)
(0,2,0,E)
(1,2,0,E)
(0,2,3,S)
(0,3,0,#)
(0,3,3,#)
(2,3,3,H)
(1,2,3,E)
(2,0,0.E)
(2,0,3,E)
(2,1,1,#)
(2,1,3,#)
(2,2,0,E)
(2,3,1,#)
(1,0,3,E)