L
2
3
(0,0,0,S)
(0,0,2,#)
(0,1,0,#)
(0,2,1,E)
(0,2,2,#)
(1,0,1,H)
(1,1,0,E)
(1,1,2,#)
(1,2,1,E)
