L
5
2
(0,0,0,#)
(0,0,1,#)
(0,1,0,S)
(0,1,1,E)
(1,0,0,E)
(1,0,1,#)
(1,1,0,E)
(3,0,0,#)
(3,0,1,H)
(3,1,0,#)
(3,1,1,#)
(4,0,0,E)
(4,0,1,E)
(4,1,0,E)
(4,1,1,E)
